,inst,cup,melt start,melt stop,melt range,pcr start,pcr stop,pcr min
0,588,03f649d3-0fb5-4f82-a7e7-1ef203459579,835,58,777,198,504,167
1,585,04253c41-edfe-4b1c-899e-f0addd248ff3,1376,71,1305,323,886,239
2,599,05b9771e-d498-4a12-9b58-93abab8d020c,998,54,944,244,580,197
3,588,0bcf09e8-2abc-47bf-a732-c51ec02518f2,979,62,917,246,597,184
4,599,126244a2-341a-439d-86b3-fc7a89197ba7,994,54,940,286,577,210
5,588,14e4acd7-6a79-40ad-8f02-6ecce7b6e63b,802,61,741,192,489,185
6,591,1702b695-af70-4f5f-ba3d-72f86008a229,993,50,943,227,551,188
7,599,1d442680-947c-49d6-819d-da83bc717e25,994,52,942,256,579,183
8,585,1f62e832-6c40-4a54-8413-6f4f134de352,1089,69,1020,279,625,214
9,591,1fa3dab9-dfcf-4ecd-ae90-3c637cecc629,884,53,831,207,443,183
10,588,211f97ac-8c39-4e54-869b-572a11f91dea,975,56,919,246,582,183
11,602,2438c0c5-227c-4ed4-890b-a75da183d343,1031,52,979,202,659,173
12,585,327f8d0e-207a-4d8d-b775-c329b9740e0b,989,69,920,262,604,212
13,599,370d78cd-eda4-48a5-bf65-d1cfd3689492,871,52,819,239,495,181
14,602,493e0288-8d0e-4f6f-a7da-6d1f334d78e7,886,53,833,234,540,177
15,599,4ddaaa5d-1e1a-4262-a50b-15a2d485df55,1285,61,1224,310,806,226
16,599,518fe108-0973-4370-805d-32b76b018387,915,53,862,234,501,193
17,585,523ca906-8a4a-4ac7-b269-27d29fc0148a,1207,76,1131,252,727,252
18,599,52b510de-a47a-46da-9153-790d64e90ac1,1169,50,1119,225,712,191
19,591,53052f32-13d3-44f1-9e68-a4c89c5238d7,823,52,771,239,404,191
20,585,59799041-5fa8-41b8-9a24-c8af9795ed6e,1489,79,1410,368,892,259
21,588,5a481eef-2c5e-47c1-b7bb-fc80f36fc250,740,63,677,216,431,171
22,591,60fded9e-c28d-46b4-acf3-9d2e8f65ebb1,977,53,924,227,528,197
23,602,649ca710-98a3-4a63-8674-dd37cdb05078,846,53,793,221,513,184
24,602,6813ef38-b5e1-4ece-9b0b-f29b4b0ababe,1049,54,995,209,665,182
25,591,6fd99e6c-f81c-4f60-971b-2e20b78b2692,871,56,815,199,404,199
26,602,70b801f3-82bb-48c6-8d8b-dc91be6ad534,914,53,861,249,549,193
27,602,7178d64f-938b-4391-be28-324d1acbafc9,890,49,841,198,547,162
28,602,71b99c09-2a47-4e41-91f0-a8b43225b8d6,845,53,792,278,543,170
29,599,74e2f338-994b-4491-afcf-1edc0635caf8,1174,53,1121,226,722,196
30,599,82fcfc63-96d5-47e8-b904-3b4c707a7344,1119,52,1067,237,689,201
31,599,83a1ad6c-0240-4c15-8c1c-21343cc28b55,1271,53,1218,259,805,202
32,602,84729d16-ffd0-4e23-83f4-1d5b2dab2f1a,851,52,799,261,523,180
33,585,85ee79c6-5bef-4c3b-978a-e5613f918ff5,1477,76,1401,342,889,265
34,591,8667674a-1d2e-4e35-95e5-0d2729987edd,1281,56,1225,265,717,210
35,602,87e41688-98ea-4a31-9041-c93ec9dabbf4,1111,58,1053,265,746,210
36,591,8af4a1d1-c450-44db-a8d7-0ef58ee2c01c,900,51,849,189,474,172
37,588,93c062d6-9723-41c0-8a0e-7ad3ee9a4dec,1027,63,964,205,630,200
38,585,959584ee-1848-4314-9238-60e493772361,1239,73,1166,337,751,246
39,588,95aa9155-9c15-4b60-aaac-0a1ef5428e65,929,58,871,206,578,181
40,602,96239bec-a039-4689-bd57-1e2ff5885902,986,52,934,208,628,165
41,602,96ff4b86-f467-4294-b846-81ee11e70f15,861,56,805,272,534,194
42,599,a2172f61-fa8b-4b1c-bb4f-f3995e37c944,1447,60,1387,281,967,231
43,591,a63c8f1f-171a-430c-88f2-982f908939f1,747,48,699,194,353,174
44,602,a911f8a1-0397-45cc-8fa7-fb740d6f30f5,953,55,898,276,650,193
45,585,acd04ff1-8361-4707-9449-a7354f0c85bd,1148,61,1087,285,721,208
46,602,adc2b8c7-d515-4d68-8f07-d792b890e56a,1004,51,953,257,659,177
47,591,b1494efa-6f26-4240-8d90-49dcae63de8d,980,50,930,228,511,188
48,588,b1cdf860-aff3-4aa2-b099-1725cba9b301,858,60,798,222,517,187
49,599,b4c80a7d-7675-46c7-8912-e8d3b7782c7f,1153,53,1100,236,705,188
50,585,bb80a39d-55d3-4780-934e-023d53b577fe,1081,71,1010,255,630,218
51,585,bfb26223-878f-425c-898a-f060e372c3af,1209,74,1135,355,696,263
52,588,c1e15e14-f5d2-48bf-b217-ee8c8cdc70f2,864,58,806,218,513,182
53,585,c2f666db-c914-4eef-af64-818e7ed64f5d,1029,73,956,269,579,229
54,588,c57f4c85-1425-4438-a8da-729dfd6eae71,791,58,733,207,476,174
55,591,c679a438-40aa-4ee3-be53-551e8808ca19,829,52,777,212,401,181
56,588,cb3322c3-cffa-45f5-b0fc-d2ec3dddf2fd,1173,53,1120,266,854,193
57,585,cffe8ce7-23d8-4481-9e91-197b8d456bbf,844,73,771,227,468,210
58,599,d3892558-7610-4ef6-8809-cb215a4b62a9,871,55,816,269,504,188
59,585,de8782f1-5780-4426-9045-00e282efc464,1006,69,937,315,563,221
60,585,e1dcebad-ffc5-4ebd-8a10-af3c1b889f20,1088,71,1017,276,632,230
61,591,e749b28a-c047-43c4-af60-55be1f297656,694,45,649,137,313,137
62,602,e76b1282-fff1-4ce7-83df-afbf9160b56b,951,50,901,199,627,169
63,591,eec251a8-fafd-4e36-9a5c-7cdda8e44a13,1184,54,1130,220,690,190
64,591,f4a8f608-2e6b-4022-8cbe-d52674e6d0d8,891,50,841,203,475,169
65,588,f4f7fcec-086f-4eb4-a069-e2c4d9324418,847,60,787,216,507,180
66,588,f72ffa45-df44-4eda-9a36-d15f49e8c0c2,939,58,881,190,555,190
67,588,fb910b18-dd9b-4c9b-a80e-45afc2fd763f,883,60,823,206,528,161
