,cup id,instrument,fmax,melt start,melt stop,melt range,pcr start,pcr stop,pcr min,reverse cq,mean pcr,mean pcr 90% ci
0,03f649d3-0fb5-4f82-a7e7-1ef203459579,588,13,67,37,30,43,54,41,5.0,43.06666666666667,0.8433335063282286
1,04253c41-edfe-4b1c-899e-f0addd248ff3,585,24,108,59,49,71,89,65,5.0,69.55555555555556,1.4900331649983087
2,05b9771e-d498-4a12-9b58-93abab8d020c,599,13,64,30,34,39,49,36,5.0,37.53333333333333,0.7582220234361472
3,0bcf09e8-2abc-47bf-a732-c51ec02518f2,588,17,74,42,32,48,60,43,6.0,46.355555555555554,0.9688392521684079
4,126244a2-341a-439d-86b3-fc7a89197ba7,599,13,66,32,34,42,51,38,6.0,39.888888888888886,0.7852379746548976
5,14e4acd7-6a79-40ad-8f02-6ecce7b6e63b,588,11,66,38,28,48,54,43,11.0,45.0,0.6648397538892254
6,1702b695-af70-4f5f-ba3d-72f86008a229,591,14,85,48,37,57,68,54,5.0,55.666666666666664,0.7830155032682953
7,1d442680-947c-49d6-819d-da83bc717e25,599,14,63,30,33,38,48,34,7.0,36.577777777777776,0.8107297840544092
8,1f62e832-6c40-4a54-8413-6f4f134de352,585,15,95,55,40,66,77,62,5.0,64.73333333333333,0.8550866801461439
9,1fa3dab9-dfcf-4ecd-ae90-3c637cecc629,591,11,81,49,32,58,64,53,8.0,56.6,0.5077329474017347
10,211f97ac-8c39-4e54-869b-572a11f91dea,588,13,70,37,33,48,55,42,7.0,44.6,0.8088124687220102
11,2438c0c5-227c-4ed4-890b-a75da183d343,602,17,69,33,36,42,55,38,10.0,41.2,1.110693904660799
12,327f8d0e-207a-4d8d-b775-c329b9740e0b,585,14,91,55,36,67,76,62,6.0,64.86666666666666,0.873562908342226
13,370d78cd-eda4-48a5-bf65-d1cfd3689492,599,11,62,32,30,41,48,37,5.0,38.977777777777774,0.6029583294674552
14,493e0288-8d0e-4f6f-a7da-6d1f334d78e7,602,13,68,36,32,49,55,42,11.0,45.355555555555554,0.7402486151239103
15,4ddaaa5d-1e1a-4262-a50b-15a2d485df55,599,19,75,32,43,45,58,39,8.0,42.13333333333333,1.1658110032029754
16,518fe108-0973-4370-805d-32b76b018387,599,10,60,28,32,40,45,35,18.0,36.577777777777776,0.5763594024040586
17,523ca906-8a4a-4ac7-b269-27d29fc0148a,585,18,104,63,41,75,88,70,10.0,73.91111111111111,0.969819892034991
18,52b510de-a47a-46da-9153-790d64e90ac1,599,18,70,29,41,39,53,35,10.0,37.71111111111111,1.1247545985977396
19,53052f32-13d3-44f1-9e68-a4c89c5238d7,591,10,79,49,30,55,63,53,10.0,54.62222222222222,0.5212814401105703
20,59799041-5fa8-41b8-9a24-c8af9795ed6e,585,21,114,64,50,80,93,72,11.0,76.37777777777778,1.2595091409716161
21,5a481eef-2c5e-47c1-b7bb-fc80f36fc250,588,9,67,42,25,50,55,46,6.0,47.577777777777776,0.5299620238634617
22,60fded9e-c28d-46b4-acf3-9d2e8f65ebb1,591,14,84,49,35,54,67,53,14.0,55.17777777777778,0.7669888479089835
23,649ca710-98a3-4a63-8674-dd37cdb05078,602,12,64,34,30,43,51,39,15.0,41.733333333333334,0.7052195955070175
24,6813ef38-b5e1-4ece-9b0b-f29b4b0ababe,602,18,71,34,37,42,57,39,9.0,41.91111111111111,1.137611595259095
25,6fd99e6c-f81c-4f60-971b-2e20b78b2692,591,10,81,50,31,55,62,52,6.0,53.93333333333333,0.5610940555850945
26,70b801f3-82bb-48c6-8d8b-dc91be6ad534,602,13,64,31,33,43,50,37,9.0,39.84444444444444,0.7626388072088375
27,7178d64f-938b-4391-be28-324d1acbafc9,602,16,62,30,32,34,48,32,5.0,35.68888888888889,1.033864912835341
28,71b99c09-2a47-4e41-91f0-a8b43225b8d6,602,11,68,42,26,52,56,45,,48.86666666666667,0.7235815246546125
29,74e2f338-994b-4491-afcf-1edc0635caf8,599,18,71,31,40,39,55,37,16.0,39.37777777777778,1.1192477764898001
30,82fcfc63-96d5-47e8-b904-3b4c707a7344,599,17,69,31,38,39,54,37,11.0,39.15555555555556,1.0626111077357479
31,83a1ad6c-0240-4c15-8c1c-21343cc28b55,599,21,74,30,44,39,57,36,5.0,38.955555555555556,1.3728947985847597
32,84729d16-ffd0-4e23-83f4-1d5b2dab2f1a,602,14,60,28,32,40,48,34,5.0,37.15555555555556,0.8115501039763799
33,85ee79c6-5bef-4c3b-978a-e5613f918ff5,585,23,113,62,51,77,92,69,9.0,73.66666666666667,1.3221519450269028
34,8667674a-1d2e-4e35-95e5-0d2729987edd,591,19,100,50,50,65,77,58,7.0,61.4,1.075209277728824
35,87e41688-98ea-4a31-9041-c93ec9dabbf4,602,20,79,40,39,55,66,46,11.0,51.355555555555554,1.2096943395876707
36,8af4a1d1-c450-44db-a8d7-0ef58ee2c01c,591,10,83,50,33,59,67,57,13.0,58.422222222222224,0.5353159124022255
37,93c062d6-9723-41c0-8a0e-7ad3ee9a4dec,588,16,77,40,37,49,62,46,12.0,48.577777777777776,0.9333592597503326
38,959584ee-1848-4314-9238-60e493772361,585,18,102,60,42,73,85,67,5.0,70.0,1.0746787031701217
39,95aa9155-9c15-4b60-aaac-0a1ef5428e65,588,14,72,38,34,45,58,44,18.0,45.977777777777774,0.873381531991555
40,96239bec-a039-4689-bd57-1e2ff5885902,602,21,69,33,36,36,55,34,5.0,37.86666666666667,1.475652475875016
41,96ff4b86-f467-4294-b846-81ee11e70f15,602,13,68,37,31,49,56,43,6.0,46.06666666666667,0.7464718085028679
42,a2172f61-fa8b-4b1c-bb4f-f3995e37c944,599,26,84,35,49,43,67,41,11.0,44.644444444444446,1.7181217655601628
43,a63c8f1f-171a-430c-88f2-982f908939f1,591,8,66,37,29,44,50,42,9.0,43.577777777777776,0.41874482571902405
44,a911f8a1-0397-45cc-8fa7-fb740d6f30f5,602,18,72,39,33,48,61,43,6.0,46.13333333333333,1.1621360618227072
45,acd04ff1-8361-4707-9449-a7354f0c85bd,585,19,94,51,43,66,78,59,5.0,62.2,1.1995676745640793
46,adc2b8c7-d515-4d68-8f07-d792b890e56a,602,18,68,29,39,41,53,35,7.0,38.733333333333334,1.1345716000262769
47,b1494efa-6f26-4240-8d90-49dcae63de8d,591,13,84,48,36,57,66,53,15.0,55.333333333333336,0.6669809502663995
48,b1cdf860-aff3-4aa2-b099-1725cba9b301,588,13,69,40,29,47,57,44,5.0,46.266666666666666,0.8382459865072533
49,b4c80a7d-7675-46c7-8912-e8d3b7782c7f,599,18,69,30,39,38,53,35,5.0,37.577777777777776,1.1346833034429125
50,bb80a39d-55d3-4780-934e-023d53b577fe,585,16,96,59,37,68,80,64,14.0,66.91111111111111,0.9153632038609345
51,bfb26223-878f-425c-898a-f060e372c3af,585,16,103,61,42,76,84,68,11.0,71.64444444444445,0.9096337722059786
52,c1e15e14-f5d2-48bf-b217-ee8c8cdc70f2,588,11,68,38,30,46,54,43,10.0,44.8,0.659672527206645
53,c2f666db-c914-4eef-af64-818e7ed64f5d,585,14,96,60,36,71,79,65,11.0,68.53333333333333,0.7804619867905274
54,c57f4c85-1425-4438-a8da-729dfd6eae71,588,12,65,38,27,43,53,41,15.0,42.955555555555556,0.7700809755655911
55,c679a438-40aa-4ee3-be53-551e8808ca19,591,9,79,48,31,55,62,53,8.0,54.68888888888889,0.43978168480443003
56,cb3322c3-cffa-45f5-b0fc-d2ec3dddf2fd,588,30,80,32,48,41,67,37,18.0,44.111111111111114,1.9989624638744132
57,cffe8ce7-23d8-4481-9e91-197b8d456bbf,585,10,91,66,25,68,77,67,7.0,68.77777777777777,0.5442966754795435
58,d3892558-7610-4ef6-8809-cb215a4b62a9,599,10,62,32,30,44,48,38,5.0,39.644444444444446,0.6231158727339405
59,de8782f1-5780-4426-9045-00e282efc464,585,12,93,58,35,72,76,64,5.0,66.68888888888888,0.6979483977832075
60,e1dcebad-ffc5-4ebd-8a10-af3c1b889f20,585,14,97,59,38,71,80,66,7.0,68.82222222222222,0.8050822168072074
61,e749b28a-c047-43c4-af60-55be1f297656,591,5,65,37,28,49,50,45,12.0,47.022222222222226,0.3439672015334949
62,e76b1282-fff1-4ce7-83df-afbf9160b56b,602,22,67,33,34,37,55,33,16.0,37.91111111111111,1.489331257211063
63,eec251a8-fafd-4e36-9a5c-7cdda8e44a13,591,20,94,51,43,58,75,55,5.0,57.68888888888889,1.1830776218570591
64,f4a8f608-2e6b-4022-8cbe-d52674e6d0d8,591,11,80,46,34,54,62,51,5.0,53.0,0.5946507535362144
65,f4f7fcec-086f-4eb4-a069-e2c4d9324418,588,12,67,37,30,44,54,42,5.0,43.6,0.7653346049652967
66,f72ffa45-df44-4eda-9a36-d15f49e8c0c2,588,12,69,35,34,45,54,42,11.0,44.355555555555554,0.7869309079344049
67,fb910b18-dd9b-4c9b-a80e-45afc2fd763f,588,14,70,38,32,47,56,42,9.0,45.0,0.8375653156791998
